9 22
. . @ @ @ @ . . . @ @ @ @ . . . @ @ @ @ . .
. . . . . . . @ . . . . . . @ . . . . . . .
. . @ @ @ @ . @ . @ @ @ @ . @ . @ @ @ @ . .
. . . . . . . @ . . . . . . @ . . . . . . .
. . @ @ @ @ . . . @ @ @ @ . . . @ @ @ @ . .
. . . . . . . @ . . . . . . @ . . . . . . .
. . @ @ @ @ . @ . @ @ @ @ . @ . @ @ @ @ . .
. . . . . . . @ . . . . . . @ . . . . . . .
. . @ @ @ @ . . . @ @ @ @ . . . @ @ @ @ . .
10
2 21 5 15
3 18 7 13
3 12 3 17
5 12 1 11
7 10 6 6
2 8 1 8
8 7 6 0
0 15 8 14
3 9 3 2
5 2 5 16