9 22
. . @ @ @ @ . . . @ @ @ @ . . . @ @ @ @ . .
. . . . . . . @ . . . . . . @ . . . . . . .
. . @ @ @ @ . @ . @ @ @ @ . @ . @ @ @ @ . .
. . . . . . . @ . . . . . . @ . . . . . . .
. . @ @ @ @ . . . @ @ @ @ . . . @ @ @ @ . .
. . . . . . . @ . . . . . . @ . . . . . . .
. . @ @ @ @ . @ . @ @ @ @ . @ . @ @ @ @ . .
. . . . . . . @ . . . . . . @ . . . . . . .
. . @ @ @ @ . . . @ @ @ @ . . . @ @ @ @ . .
13
5 15 7 8
7 0 3 8
8 8 1 9
0 13 6 6
3 12 8 6
7 19 2 8
7 17 7 20
5 8 7 18
1 19 3 11
1 0 2 1
1 12 5 2
8 0 3 21
7 5 7 3