9 22
. . @ @ @ @ . . . @ @ @ @ . . . @ @ @ @ . .
. . . . . . . @ . . . . . . @ . . . . . . .
. . @ @ @ @ . @ . @ @ @ @ . @ . @ @ @ @ . .
. . . . . . . @ . . . . . . @ . . . . . . .
. . @ @ @ @ . . . @ @ @ @ . . . @ @ @ @ . .
. . . . . . . @ . . . . . . @ . . . . . . .
. . @ @ @ @ . @ . @ @ @ @ . @ . @ @ @ @ . .
. . . . . . . @ . . . . . . @ . . . . . . .
. . @ @ @ @ . . . @ @ @ @ . . . @ @ @ @ . .
7
1 10 5 15
3 10 3 9
6 6 6 8
2 0 1 18
4 21 4 8
3 16 3 15
7 9 1 11