9 22
. . @ @ @ @ . . . @ @ @ @ . . . @ @ @ @ . .
. . . . . . . @ . . . . . . @ . . . . . . .
. . @ @ @ @ . @ . @ @ @ @ . @ . @ @ @ @ . .
. . . . . . . @ . . . . . . @ . . . . . . .
. . @ @ @ @ . . . @ @ @ @ . . . @ @ @ @ . .
. . . . . . . @ . . . . . . @ . . . . . . .
. . @ @ @ @ . @ . @ @ @ @ . @ . @ @ @ @ . .
. . . . . . . @ . . . . . . @ . . . . . . .
. . @ @ @ @ . . . @ @ @ @ . . . @ @ @ @ . .
10
8 14 7 12
7 0 7 16
1 2 4 14
2 21 0 21
6 0 5 0
1 12 7 2
1 3 1 15
6 15 3 13
6 8 7 20
7 6 1 0